10,10,10,10,10,10,10,10,10,10,10,10,10,10,10,10
10,10,10,10,10,10,10,10,10,10,10,10,10,10,10,10
10,10,10,10,10,10,10,10,10,10,10,10,10,10,10,10
10,11,12,13,10,10,11,12,13,10,10,10,11,12,13,10
9,14,15,16,9,9,14,15,16,9,9,9,14,15,16,9
8,17,18,19,5,8,17,18,19,8,8,7,17,18,19,5
0,0,0,0,0,0,0,0,0,0,0,0,0,0,0,0
1,1,1,1,1,1,1,1,1,1,1,1,1,1,1,1
2,3,2,3,2,3,2,3,2,3,2,3,2,3,2,3
1,1,1,1,1,1,1,1,1,1,1,1,1,1,1,1
1,1,1,1,1,1,1,1,1,1,1,1,1,1,1,1
4,4,4,4,20,21,22,4,4,4,20,21,22,4,4,4
